25 22
**********************
*              *     *
*              *     *
*  **********  *  *  *
*     *        *  *  *
*     *        *  *  *
*  *  *  *******  *  *
*  *  *     *     *  *
*  *  *     *     *  *
*  *  ****  *  ****  *
*  *  *     *  *     *
*  *  *     *  *     *
*  ****  ****  *  ****
*  *     *     *     *
*  *     *     *     *
*  *  ****  ****  ****
*  *        * @   * $*
*  *        *     *  *
*  ****************  *
*           *        *
*           *        *
*******     *  *******
*        *           *
*        *           *
**********************