31 26
**************************
*           *       *    *
*           *       *    *
*  *******  *  ******  ***
*  *        *  *         *
*  *        *  *         *
*  *  *******  *  *****  *
*  *  *        *    *    *
*  *  *        *    *    *
*  *  *  *********  *  ***
*  *     *     *    *    *
*  *     *     *  ***    *
*  ****  *  *  *  *      *
*     *  *  *  *  *   ****
***   *  *  *  *  *   *  *
*     *  *  *  *  *   *  *
*     *  *  *  *  *      *
*  ****  *  *  *  *      *
*  *     *  *  *  ****   *
*  *     *  *  *     *   *
*  *  *  *  *  *     *   *
*  *  *  *  *  ****  *   *
*  *  *     *    @*  *   *
*  *  *     *     *  *   *
*  *  *************  *   *
*  *              *  *   *
*  *              *  *   *
*  ****************  *   *
*                    *   *
*                    * $ *
**************************