18 18
******************
*             *  *
*             *  *
*  *********  *  *
*     *       *  *
*     *       *  *
*  *  *  ******  *
*  *  *          *
*  *  *          *
*  *  ****  ******
*  *     *  *    *
*  *     *  *    *
*******  *       *
*     *  *       *
*     *  ******  *
*  *     *@      *
* $*     *       *
******************